1 450 851
1 450 821
1 450 791
1 480 791
1 510 791
1 540 791
1 540 821
1 540 851
3 60 41
3 60 101
3 60 161
3 60 221
2 0 101
2 0 221
2 120 161
1 180 41
1 210 41
1 210 71
1 180 71
1 180 101
1 210 101
1 210 131
1 180 131
1 180 161
1 210 161
1 210 191
1 180 191
1 180 221
1 210 221
1 210 251
1 180 251
2 120 41
2 240 221
2 300 221
2 360 221
2 540 221
2 420 221
2 600 221
2 660 221
2 720 221
3 900 41
3 900 101
3 900 161
3 900 221
1 810 221
1 780 221
1 780 251
1 810 251
1 810 191
1 810 161
1 810 131
1 810 101
1 810 71
1 810 41
1 780 41
1 780 71
1 780 101
1 780 131
1 780 161
1 780 191
2 960 101
2 960 221
2 840 161
2 840 41
0 450 41
0 450 71
0 450 101
0 450 131
0 450 171
0 450 161
0 450 191
0 540 191
0 540 161
0 540 131
0 540 101
0 540 71
0 540 41
1 510 221
1 480 221
1 480 251
1 510 251
1 0 611
1 30 611
1 60 611
1 90 611
1 120 611
1 150 611
1 180 611
1 210 611
1 240 611
1 270 611
1 300 611
1 330 611
1 360 611
1 390 611
1 420 611
1 450 611
1 540 611
1 570 611
1 600 611
1 630 611
1 660 611
1 690 611
1 720 611
1 750 611
1 780 611
1 810 611
1 840 611
1 870 611
1 900 611
1 930 611
1 960 611
1 990 611
1 60 351
1 90 351
1 120 351
1 150 351
1 180 351
1 210 351
1 130 381
1 130 411
1 130 441
1 130 471
1 130 501
1 130 531
1 270 351
1 300 351
1 330 351
1 360 351
1 390 351
1 420 351
1 270 381
1 270 411
1 270 441
1 270 471
1 270 501
1 270 531
1 300 531
1 330 531
1 360 531
1 390 531
1 420 531
1 300 441
1 330 441
1 360 441
1 390 441
1 420 441
1 540 531
1 570 531
1 600 531
1 630 531
1 660 531
1 690 531
1 680 351
1 650 351
1 620 351
1 590 351
1 560 351
1 530 351
1 530 381
1 530 411
1 530 441
1 560 441
1 590 441
1 620 441
1 650 441
1 680 441
1 680 471
1 680 501
1 760 351
1 790 351
1 820 351
1 850 351
1 880 351
1 910 351
1 830 381
1 830 411
1 830 441
1 830 471
1 830 501
1 830 531
0 710 531
0 740 531
0 770 531
0 800 531
0 860 531
0 890 531
0 920 531
0 950 531
0 980 531
0 1010 531
2 480 581
0 240 531
0 210 531
0 180 531
0 160 531
0 100 531
0 70 531
0 40 531
0 10 531
0 -20 531

