2 0 161
2 60 221
2 120 221
2 180 161
2 300 161
2 420 161
2 480 221
2 540 221
2 600 161
2 660 221
2 660 281
2 660 341
2 720 401
2 720 461
2 660 461
2 720 581
2 660 641
2 600 581
2 540 641
2 480 641
2 420 581
2 0 581
2 60 641
2 120 641
2 180 581
2 240 581
2 300 581
2 360 581
3 0 341
3 60 341
3 120 341
3 60 581
3 120 581
3 120 521
3 180 521
3 480 581
3 540 581
3 480 521
3 420 521
3 240 521
3 360 521
3 420 461
3 180 461
3 660 581
3 660 521
3 720 521
3 660 401
3 600 401
3 600 341
3 540 341
3 480 341
1 240 161
1 270 161
1 270 131
1 240 131
1 240 101
1 270 101
1 270 191
1 240 191
1 240 221
1 270 221
1 300 221
1 330 221
1 360 221
1 390 221
1 420 221
1 450 221
1 390 191
1 390 161
1 390 131
1 390 101
1 360 101
1 360 131
1 360 161
1 360 191
1 180 221
1 210 221
1 210 251
1 180 251
1 240 251
1 270 251
1 300 251
1 330 251
1 360 251
1 390 251
1 420 251
1 450 251
0 240 281
0 270 281
0 270 311
0 240 311
0 360 281
0 390 281
0 390 311
0 360 311
1 0 311
1 0 281
1 0 251
1 0 221
1 30 221
1 30 251
1 30 281
1 30 311
1 60 311
1 90 311
1 120 311
1 150 311
1 180 311
1 210 311
1 210 281
1 180 281
1 150 281
1 120 281
1 90 281
1 60 281
1 300 281
1 330 281
1 330 311
1 300 311
1 420 311
1 420 281
1 450 281
1 480 281
1 510 281
1 540 281
1 570 281
1 600 281
1 630 281
1 630 251
1 630 221
1 600 221
1 600 221
1 600 251
1 600 311
1 630 311
1 570 311
1 540 311
1 510 311
1 480 311
1 450 311
1 450 341
1 450 371
1 420 371
1 390 371
1 360 371
1 330 371
1 300 371
1 270 371
1 240 371
1 210 371
1 180 371
1 180 341
1 210 341
1 240 341
1 270 341
1 300 341
1 330 341
1 360 341
1 390 341
1 420 341
1 420 401
1 450 401
1 480 401
1 510 401
1 540 401
1 570 401
1 570 431
1 540 431
1 510 431
1 480 431
1 450 431
1 420 431
1 480 461
1 510 461
1 540 461
1 570 461
1 600 461
1 630 461
1 630 491
1 630 521
1 630 551
1 600 551
1 570 551
1 540 551
1 540 521
1 570 521
1 600 521
1 600 491
1 570 491
1 540 491
1 510 491
1 480 491
1 390 491
1 390 461
1 390 431
1 390 401
1 360 401
1 360 431
1 360 461
1 360 491
1 330 491
1 300 491
1 270 491
1 240 491
1 240 461
1 240 431
1 240 401
1 270 401
1 300 401
1 330 401
1 330 431
1 330 461
1 300 461
1 280 461
1 270 461
1 270 431
1 300 431
1 300 521
1 330 521
1 330 551
1 300 551
1 210 401
1 210 431
1 180 431
1 180 401
1 150 401
1 120 401
1 90 401
1 60 401
1 60 431
1 90 431
1 120 431
1 150 431
1 150 461
1 150 491
1 120 491
1 90 491
1 60 491
1 30 491
1 0 491
1 0 461
1 30 461
1 60 461
1 90 461
1 120 461
1 90 521
1 60 521
1 30 521
1 0 521
1 0 551
1 30 551
1 60 551
1 90 551
1 450 851
1 450 821
1 450 791
1 480 791
1 510 791
1 540 791
1 540 821
1 540 851
3 780 521
3 810 521
3 840 521
3 960 521
3 900 521
2 780 581
2 810 581
2 840 581
2 870 581
2 900 581
2 930 581
2 960 581
2 960 461
2 900 461
2 840 461
2 780 461
