1 60 41
1 90 41
1 180 41
1 210 41
1 300 41
1 330 41
1 930 41
1 900 41
1 810 41
1 780 41
1 690 41
1 660 41
1 660 71
1 690 71
1 690 101
1 660 101
1 660 131
1 690 131
1 690 161
1 660 161
1 780 71
1 810 71
1 810 101
1 790 101
1 780 101
1 780 131
1 810 131
1 810 161
1 780 161
1 900 71
1 930 71
1 930 101
1 930 131
1 900 131
1 900 101
1 900 161
1 930 161
1 330 71
1 300 71
1 300 101
1 330 101
1 330 131
1 300 131
1 300 161
1 330 161
1 210 71
1 180 71
1 180 101
1 210 101
1 210 131
1 180 131
1 180 161
1 210 161
1 90 71
1 60 71
1 60 101
1 90 101
1 90 131
1 60 131
1 60 161
1 90 161
0 90 191
0 60 191
0 180 191
0 210 191
0 300 191
0 330 191
0 660 191
0 690 191
0 780 191
0 810 191
0 900 191
0 930 191
1 480 331
1 510 331
0 480 361
0 510 361
1 0 301
1 30 301
1 30 331
1 0 331
1 120 301
1 150 301
1 150 271
1 120 271
1 120 331
1 150 331
1 180 291
1 210 291
1 240 291
1 270 291
1 270 321
1 240 321
0 120 361
0 150 361
0 240 361
0 270 361
1 270 331
1 240 331
1 990 301
1 960 301
1 960 331
1 990 331
1 870 271
1 840 271
1 840 301
1 870 301
1 870 331
1 840 331
1 810 291
1 780 291
1 750 291
1 720 291
1 720 321
1 750 321
0 720 361
0 750 361
0 840 361
0 870 361
1 750 331
1 720 331
1 720 391
1 750 391
1 750 421
1 720 421
1 720 451
1 750 451
1 750 481
1 720 481
1 690 481
1 660 481
1 660 451
1 690 451
1 240 391
1 270 391
1 270 421
1 240 421
1 240 451
1 270 451
1 270 481
1 240 481
1 300 481
1 300 451
1 330 451
1 330 481
1 120 241
1 150 241
1 840 241
1 870 241
2 300 391
2 360 391
2 420 391
2 480 391
2 540 391
2 600 391
2 660 391
2 600 451
2 540 451
2 480 451
2 420 451
2 360 451
2 180 451
2 120 451
2 60 451
2 0 451
2 0 391
2 960 391
2 960 451
2 900 451
2 840 451
2 780 451
2 960 511
2 900 511
2 840 511
2 780 511
2 720 511
2 660 511
2 600 511
2 540 511
2 480 511
2 420 511
2 360 511
2 300 511
2 240 511
2 180 511
2 120 511
2 60 511
2 0 511
2 300 571
2 360 571
2 420 571
2 480 571
2 540 571
2 600 571
2 660 571
2 480 631
1 270 571
1 240 571
1 240 601
1 270 601
1 720 601
1 750 601
1 750 571
1 720 571
1 0 601
1 30 601
1 60 631
1 90 631
1 120 601
1 150 601
1 180 631
1 210 631
1 210 661
1 180 661
1 180 691
1 210 691
1 210 721
1 180 721
1 60 661
1 90 661
1 90 691
1 90 721
1 60 721
1 60 691
1 780 631
1 810 631
1 810 661
1 810 691
1 810 721
1 780 721
1 780 691
1 780 671
1 780 661
1 840 601
1 870 601
1 900 631
1 930 631
1 960 601
1 990 601
1 900 661
1 900 691
1 900 721
1 930 721
1 930 691
1 930 661
3 420 331
3 540 331
3 360 331
3 600 331
1 450 851
1 450 821
1 450 791
1 480 791
1 510 791
1 540 791
1 540 821
1 540 851
1 450 41
1 420 41
1 540 41
1 570 41
1 420 71
1 450 71
1 540 71
1 570 71
3 540 101
3 420 101
1 420 161
1 450 161
1 540 161
1 570 161
1 570 191
1 540 191
1 450 191
1 420 191
