1 180 71
1 210 71
1 240 71
1 270 71
1 300 71
1 330 71
1 360 71
1 390 71
1 150 101
1 120 101
1 120 131
1 150 131
1 90 131
1 60 131
2 60 161
2 60 221
2 0 221
2 0 281
2 0 341
2 0 401
2 0 461
2 120 161
2 180 161
2 230 161
2 240 161
2 300 161
2 360 161
2 420 161
2 480 161
2 480 221
2 540 221
2 540 281
2 600 281
2 660 281
2 660 341
2 600 341
2 540 341
2 540 401
2 480 401
2 480 461
2 420 461
2 360 461
2 300 461
2 240 461
2 180 461
2 120 461
2 60 461
2 60 521
2 120 521
2 300 521
2 360 521
2 420 521
1 180 101
1 210 101
1 240 101
1 270 101
1 300 101
1 330 101
1 360 101
1 390 101
1 420 101
1 450 101
1 480 101
1 690 251
1 690 221
1 660 221
1 630 221
1 600 221
1 600 251
1 630 251
1 660 251
1 630 191
1 630 161
1 600 161
1 570 161
1 540 161
1 540 191
1 570 191
1 600 191
1 570 131
1 570 101
1 540 101
1 510 101
1 510 131
1 540 131
1 480 131
1 450 131
1 420 131
1 390 131
1 360 131
1 330 131
1 300 131
1 270 131
1 240 131
1 210 131
1 180 131
1 540 71
1 570 71
1 720 401
2 180 401
1 180 521
1 210 521
1 240 521
1 270 521
1 270 551
1 240 551
1 210 551
1 180 551
1 30 551
1 0 551
1 0 521
1 30 521
1 480 521
1 510 521
1 510 551
1 480 551
1 540 551
1 720 431
1 720 461
1 720 491
1 690 491
1 690 521
1 690 551
1 660 551
1 630 581
1 600 581
1 600 611
1 600 641
1 600 401
1 630 401
1 660 401
1 690 401
1 690 431
1 690 461
1 660 461
1 630 461
1 600 461
1 570 461
1 540 461
1 540 491
1 540 521
1 570 521
1 600 521
1 630 521
1 660 521
1 660 491
1 660 431
1 630 431
1 600 431
1 600 491
1 570 491
1 630 491
1 630 551
1 600 551
1 570 551
1 570 581
1 530 581
1 540 581
1 510 581
1 480 581
1 450 581
1 420 581
1 390 581
1 360 581
1 330 581
1 300 581
1 270 581
1 240 581
1 210 581
1 180 581
1 150 581
1 120 581
1 90 581
1 60 581
1 30 581
1 0 581
1 60 611
1 90 611
1 120 611
1 150 611
1 180 611
1 210 611
1 240 611
1 270 611
1 300 611
1 330 611
1 360 611
1 390 611
1 410 611
1 440 611
1 470 611
1 500 611
1 530 611
1 560 611
1 570 611
0 30 641
0 0 641
0 0 671
0 30 671
0 60 701
0 90 701
0 90 731
0 60 731
0 180 671
0 210 671
0 210 641
0 180 641
0 240 701
0 270 701
0 270 731
0 240 731
1 120 641
1 150 641
1 150 671
1 120 671
1 120 701
1 150 701
1 180 701
1 210 701
1 120 731
1 150 731
1 240 641
1 270 641
1 300 641
1 330 641
1 360 641
1 390 641
1 420 641
1 450 641
1 480 641
1 510 641
1 540 641
1 570 641
0 570 671
0 570 701
0 600 701
0 600 671
0 630 671
0 660 671
0 690 671
0 720 671
0 720 581
0 750 581
0 750 611
0 750 641
0 750 671
0 720 641
0 720 611
0 720 701
0 750 701
0 630 701
0 660 701
0 690 701
1 240 671
1 270 671
1 300 671
1 330 671
1 360 671
1 390 671
1 420 671
1 450 671
1 480 671
1 510 671
1 540 671
1 540 701
1 510 701
1 480 701
1 450 701
1 420 701
1 390 701
1 360 701
1 330 701
1 300 701
0 120 281
0 150 281
0 150 311
0 150 341
0 150 371
0 120 371
0 120 341
0 120 311
0 300 371
0 330 371
0 330 341
0 330 311
0 330 281
0 300 281
0 300 311
0 300 341
1 300 731
1 330 731
1 360 731
1 390 731
1 420 731
1 450 731
1 480 731
1 510 731
1 540 731
1 570 731
1 600 731
1 630 731
1 660 731
1 690 731
1 600 101
1 600 131
1 850 221
1 880 221
1 880 251
1 850 251
1 850 281
1 880 281
1 880 311
1 850 311
1 850 341
1 880 341
1 880 371
1 850 371
1 850 461
1 880 461
1 880 491
1 850 491
1 450 851
1 450 821
1 450 791
1 480 791
1 510 791
1 540 791
1 540 821
1 540 851