2 120 41
2 180 41
2 180 101
2 120 101
2 120 161
2 120 221
1 90 101
1 60 101
1 60 131
1 90 131
1 180 191
1 210 191
1 210 221
1 180 221
1 120 281
1 150 281
1 150 311
1 120 311
1 90 311
1 90 281
1 60 281
1 60 311
1 60 251
1 90 251
0 30 281
0 0 281
3 0 341
0 0 311
0 30 311
1 240 311
1 270 311
0 270 341
0 240 341
0 120 401
0 150 401
0 150 431
0 120 431
1 180 401
1 210 401
1 210 431
1 180 431
1 90 431
1 60 431
1 60 401
1 90 401
1 60 461
1 90 461
1 90 491
1 60 491
1 60 521
1 90 521
1 90 551
1 60 551
3 0 821
3 0 761
3 0 641
3 0 581
3 0 521
3 0 461
2 120 521
1 180 461
1 210 461
1 210 491
1 180 491
1 180 521
1 210 521
1 210 551
1 180 551
1 180 581
1 210 581
1 210 611
1 210 641
1 210 671
1 210 701
1 0 731
1 0 701
1 30 701
1 30 731
1 60 731
1 90 731
1 120 731
1 150 731
1 180 731
1 210 731
1 180 701
1 150 701
1 120 701
1 90 701
1 60 701
1 180 611
1 180 641
1 180 671
2 60 821
2 120 821
2 180 821
2 900 821
2 840 821
0 810 821
0 780 821
0 780 851
0 810 851
3 960 701
3 960 461
3 960 521
3 960 581
3 960 641
1 930 731
1 900 731
1 870 731
1 840 731
1 810 731
1 780 731
1 780 701
1 810 701
1 840 701
1 870 701
1 900 701
1 930 701
1 930 671
1 930 641
1 930 611
1 930 591
1 930 561
1 930 531
1 930 501
1 930 471
1 930 441
1 930 411
1 930 401
1 900 401
1 870 401
1 840 401
1 810 401
1 780 401
1 780 431
1 810 431
1 840 431
1 870 431
1 900 431
1 900 461
1 900 491
1 900 521
1 900 551
1 900 581
1 900 611
1 900 641
1 900 671
1 780 671
1 810 671
1 810 641
1 780 641
2 780 581
2 780 521
2 780 461
1 750 341
1 720 341
1 720 311
1 750 311
1 450 851
1 450 821
1 450 791
1 480 791
1 510 791
1 540 791
1 540 821
1 540 851
1 480 521
1 510 521
1 510 551
1 480 551
1 450 491
1 420 491
1 420 461
1 450 461
1 450 431
1 420 431
1 480 431
1 510 431
1 540 431
1 570 431
1 600 431
1 600 461
1 570 461
1 540 461
1 510 461
1 480 461
1 540 581
1 570 581
1 600 581
1 600 611
1 570 611
1 540 611
1 600 641
1 570 641
1 550 641
1 520 641
1 490 641
1 460 641
1 430 641
1 430 671
1 460 671
1 490 671
1 520 671
1 550 671
1 580 671
1 600 671
1 510 611
1 480 611
1 450 611
1 430 611
1 420 401
1 450 401
1 480 401
1 510 401
1 540 401
1 570 401
1 600 401
1 480 291
1 510 291
1 510 261
1 480 261
0 480 231
0 510 231
0 510 201
0 480 201
1 420 171
1 390 171
1 360 171
1 330 171
1 330 141
1 360 141
1 390 141
1 420 141
1 570 171
1 600 171
1 630 171
1 660 171
1 660 141
1 630 141
1 600 141
1 570 141
2 840 41
2 840 101
2 840 161
2 840 221
2 780 41
2 780 101
1 900 101
1 930 101
1 930 131
1 900 131
1 810 181
1 780 181
1 780 211
1 810 211
0 900 281
0 930 281
0 960 281
0 990 281
0 990 311
0 960 311
0 930 311
0 900 311
1 870 311
1 840 311
1 840 281
1 870 281
2 240 521
2 300 521
2 360 521
2 420 521
3 540 521
3 600 521
3 660 521
3 720 521
0 450 141
0 480 141
0 510 141
0 540 141
