2 60 41
2 120 41
2 60 101
2 0 101
2 0 161
0 0 221
0 30 221
3 0 321
2 0 761
2 60 821
0 0 821
0 30 821
0 30 851
0 0 851
0 990 851
0 960 851
0 960 821
0 990 821
2 960 761
2 960 701
2 900 761
2 900 821
2 840 821
2 900 41
2 960 101
0 960 161
0 990 161
1 330 101
1 360 101
1 390 101
1 420 101
1 300 131
1 270 131
1 330 131
1 360 131
1 390 131
1 420 131
1 450 131
1 480 131
1 510 131
1 540 131
1 570 131
1 240 161
1 270 161
1 300 161
1 330 161
1 360 161
1 390 161
1 420 161
1 450 161
1 480 161
1 510 161
1 540 161
1 570 161
1 600 161
1 630 161
1 240 191
1 270 191
1 300 191
1 330 191
1 360 191
1 390 191
1 420 191
1 450 191
1 480 191
1 510 191
1 540 191
1 570 191
1 600 191
1 630 191
1 660 191
1 690 191
1 210 221
1 240 221
1 270 221
1 300 221
1 330 221
1 360 221
1 390 221
1 420 221
1 450 221
1 480 221
1 510 221
1 540 221
1 570 221
1 600 221
1 630 221
1 660 221
1 690 221
1 720 221
1 210 251
1 240 251
1 270 251
1 300 251
1 330 251
1 360 251
1 390 251
1 420 251
1 450 251
1 480 251
1 510 251
1 540 251
1 570 251
1 600 251
1 630 251
1 660 251
1 690 251
1 720 251
1 750 221
1 750 251
1 720 191
1 660 161
1 600 131
1 450 101
1 480 101
1 180 281
1 210 281
1 240 281
1 180 311
1 180 341
1 180 371
1 180 401
1 180 431
1 150 431
1 150 461
1 180 461
1 180 491
1 150 491
1 600 281
1 630 281
1 660 281
1 750 281
1 750 311
1 750 341
1 660 311
1 660 341
1 570 281
1 540 281
1 600 311
1 630 311
1 630 341
1 600 341
1 640 371
1 640 401
1 640 431
1 640 461
1 150 521
1 180 521
1 120 551
1 120 581
1 150 581
1 150 551
1 90 611
1 120 611
1 150 611
1 180 611
1 210 611
1 670 491
1 640 491
1 670 521
1 670 551
1 700 551
1 700 581
1 730 581
1 730 611
1 760 611
1 700 611
1 670 611
1 640 611
1 240 611
1 270 611
1 610 611
1 640 641
1 610 641
1 580 671
1 550 671
1 510 701
1 520 701
1 490 701
1 460 701
1 430 701
1 300 641
1 210 641
1 240 641
1 270 671
1 300 671
1 330 701
1 360 701
1 400 701
1 380 701
1 270 641
1 180 551
1 210 551
1 240 551
1 270 551
1 300 551
1 330 551
1 360 551
1 390 551
1 420 551
1 450 551
1 480 551
1 510 551
1 540 551
1 570 551
1 600 551
1 630 551
1 640 551
1 640 521
1 670 581
1 640 581
1 610 581
1 580 581
1 550 581
1 520 581
1 490 581
1 460 581
1 430 581
1 400 581
1 370 581
1 340 581
1 310 581
1 280 581
1 250 581
1 220 581
1 190 581
1 180 581
1 300 611
1 330 611
1 360 611
1 390 611
1 420 611
1 450 611
1 480 611
1 510 611
1 540 611
1 570 611
1 580 611
1 580 641
1 550 641
1 520 641
1 490 641
1 460 641
1 430 641
1 400 641
1 370 641
1 340 641
1 330 641
1 330 671
1 360 671
1 390 671
1 420 671
1 450 671
1 480 671
1 510 671
1 520 671
1 210 491
1 240 491
1 270 491
1 300 491
1 330 491
1 360 491
1 390 491
1 420 491
1 450 491
1 480 491
1 510 491
1 540 491
1 570 491
1 600 491
1 610 491
1 610 521
1 590 521
1 210 521
1 240 521
1 270 521
1 300 521
1 330 521
1 360 521
1 390 521
1 420 521
1 450 521
1 480 521
1 510 521
1 540 521
1 570 521
1 270 461
1 300 461
1 330 461
1 360 461
1 390 461
0 270 341
0 270 371
1 420 461
0 440 341
0 440 371
1 60 731
1 60 701
1 90 701
1 120 701
1 150 701
1 180 701
1 180 731
1 150 731
1 120 731
1 90 731
1 210 701
1 240 701
1 240 731
1 210 731
1 240 761
1 210 761
1 180 761
1 150 761
1 120 761
1 270 761
1 300 761
1 330 761
1 330 791
1 300 791
1 270 791
1 240 791
1 210 791
1 180 791
1 150 791
1 120 791
1 670 671
1 670 701
1 640 701
1 610 701
1 610 731
1 610 761
1 640 761
1 670 761
1 700 761
1 730 761
1 760 761
1 790 761
1 810 761
1 700 671
1 730 671
1 760 671
1 790 671
1 810 671
1 810 701
1 780 701
1 750 701
1 720 701
1 690 701
1 640 731
1 670 731
1 700 731
1 730 731
1 760 731
1 610 791
1 640 791
1 670 791
1 330 731
3 960 321
3 900 321
1 610 371
1 610 431
1 610 461
1 610 461
1 450 851
1 450 821
1 450 791
1 480 791
1 510 791
1 540 791
1 540 821
1 540 851