1 440 401
1 440 431
1 440 461
1 470 461
1 500 461
1 530 461
1 530 431
1 530 401
1 530 371
1 500 371
1 470 371
1 440 371
2 380 371
2 380 431
2 380 491
2 440 491
2 500 491
2 560 491
2 560 431
2 560 371
2 560 311
2 500 311
2 440 311
2 380 311
3 320 311
3 320 371
3 320 431
3 320 491
3 320 551
3 380 551
3 440 551
3 500 551
3 560 551
3 620 551
3 620 491
3 620 431
3 620 371
3 620 311
1 650 281
1 620 281
1 590 281
1 560 281
1 530 281
1 500 281
1 470 281
1 440 281
1 410 281
1 380 281
1 350 281
1 320 281
2 260 401
2 200 401
2 140 401
2 80 401
2 20 401
2 -40 401
1 290 461
1 260 461
1 230 461
1 200 461
1 170 461
1 140 461
1 110 461
1 80 461
1 50 461
1 20 461
1 -10 461
1 680 371
1 710 371
1 740 371
1 770 371
1 800 371
1 830 371
1 860 371
1 890 371
1 920 371
1 950 371
1 980 371
1 1010 371
2 680 401
2 740 401
2 800 401
2 860 401
2 920 401
2 980 401
1 0 141
1 30 141
1 60 141
1 90 141
1 40 171
1 40 201
1 40 231
1 40 261
1 150 141
1 180 141
1 210 141
1 240 141
1 150 171
1 150 201
1 150 231
1 150 261
1 180 261
1 210 261
1 240 261
1 180 201
1 210 201
1 240 201
1 740 131
1 770 131
1 800 131
1 830 131
1 740 161
1 740 191
1 770 191
1 800 191
1 830 191
1 830 221
1 830 251
1 800 251
1 770 251
1 740 251
1 890 131
1 920 131
1 950 131
1 980 131
1 1010 131
1 950 161
1 950 191
1 950 221
1 950 251
1 450 851
1 450 821
1 450 791
1 480 791
1 510 791
1 540 791
1 540 821
1 540 851