2 60 41
2 120 41
2 180 41
2 240 41
2 300 41
2 900 41
2 840 41
2 780 41
2 720 41
2 660 41
2 360 41
2 600 41
2 420 41
2 540 41
1 450 851
1 450 821
1 450 791
1 480 791
1 510 791
1 540 791
1 540 821
1 540 851
1 540 101
1 540 131
1 540 161
1 540 191
1 540 221
1 540 251
1 540 281
1 540 311
1 540 341
1 540 371
1 540 401
1 570 401
1 600 401
1 630 401
1 660 401
1 690 401
1 720 401
1 750 401
1 750 371
1 750 341
1 750 311
1 750 281
1 750 251
1 750 221
1 750 191
1 750 161
1 750 121
1 750 131
1 750 101
1 720 101
1 690 101
1 660 101
1 630 101
1 630 101
1 600 101
1 570 101
1 570 131
1 570 161
1 570 191
1 570 191
1 570 221
1 570 251
1 570 281
1 570 311
1 570 341
1 570 371
1 600 371
1 630 371
1 660 371
1 690 371
1 720 371
1 720 341
1 720 311
1 720 281
1 720 251
1 720 221
1 720 191
1 720 161
1 720 131
1 690 131
1 660 131
1 630 131
1 600 131
1 450 101
1 450 131
1 450 161
1 420 161
1 420 131
1 420 101
1 390 101
1 360 101
1 330 101
1 300 101
1 270 101
1 240 101
1 240 131
1 240 161
1 240 191
1 240 221
1 240 251
1 240 281
1 240 311
1 240 341
1 240 371
1 240 401
1 240 431
1 270 401
1 300 401
1 330 401
1 360 401
1 390 401
1 420 401
1 450 401
1 450 371
1 450 341
1 450 301
1 450 311
1 450 281
1 420 281
1 390 281
1 390 131
1 360 131
1 330 131
1 300 131
1 270 131
1 270 161
1 270 191
1 270 221
1 270 251
1 270 281
1 270 311
1 270 341
1 270 371
1 300 371
1 330 371
1 360 371
1 390 371
1 420 371
3 240 431
3 300 431
3 360 431
3 420 431
3 540 431
3 600 431
3 660 431
3 720 431
1 420 191
1 450 191
1 360 281
2 0 101
2 0 161
2 0 221
2 0 281
2 0 341
2 0 401
0 0 461
0 30 461
0 480 461
0 510 461
0 510 431
0 480 431
0 990 461
0 960 461
2 60 431
2 120 431
2 180 431
2 780 431
2 840 431
2 900 431
2 960 401
2 960 341
2 960 281
2 960 221
2 960 161
2 960 101
0 0 491
0 30 491
0 960 491
0 990 491
1 60 491
1 90 491
1 120 491
1 150 491
1 180 491
1 210 491
1 240 491
1 270 491
1 300 491
1 330 491
1 360 491
1 390 491
1 420 491
1 450 491
1 480 491
1 510 491
1 540 491
1 570 491
1 600 491
1 630 491
1 660 491
1 690 491
1 720 491
1 750 491
1 780 491
1 810 491
1 840 491
1 870 491
1 900 491
1 930 491
0 120 641
0 150 641
0 150 671
0 120 671
1 90 641
1 60 641
1 60 671
1 90 671
1 90 611
1 60 611
1 60 581
1 90 581
1 90 701
1 60 701
1 60 731
1 90 731
1 90 761
1 60 761
1 190 581
1 220 581
1 220 611
1 190 611
1 180 641
1 180 611
1 180 581
1 210 641
1 210 671
1 210 701
1 210 731
1 210 761
1 180 761
1 180 731
1 180 701
1 180 671
0 240 641
0 270 641
0 270 671
0 240 671
1 240 611
1 270 611
1 300 611
1 300 581
1 330 581
1 330 611
1 330 641
1 330 671
1 330 701
1 330 731
1 330 761
1 300 761
1 300 731
1 300 701
1 300 671
1 300 641
2 0 521
2 0 581
2 0 641
2 0 701
2 0 761
2 0 821
2 60 821
2 120 821
2 180 821
2 240 821
1 90 791
1 60 791
1 180 791
1 210 791
1 300 791
1 330 791
2 300 821
1 360 641
1 390 641
1 420 641
1 450 641
1 540 641
1 570 641
1 600 641
1 630 641
1 660 641
1 690 641
2 960 521
2 960 581
2 960 641
2 960 701
2 960 771
2 960 761
2 960 821
2 900 821
2 840 821
2 780 821
2 720 821
2 660 821
1 930 581
1 900 581
1 900 611
1 930 611
1 930 641
1 930 671
1 930 701
1 930 731
1 930 761
1 930 791
1 900 791
1 900 761
1 900 731
1 900 701
1 900 671
1 900 641
0 870 641
0 840 641
0 840 671
0 870 671
1 810 641
1 780 641
0 750 641
0 720 641
0 720 671
0 750 671
1 250 581
1 280 581
1 690 671
1 660 671
1 660 611
1 690 611
1 720 611
1 750 611
1 780 611
1 810 611
1 810 581
1 780 581
1 750 581
1 720 581
1 690 581
1 660 581
1 660 701
1 660 731
1 660 761
1 660 791
1 690 791
1 690 761
1 690 731
1 690 701
1 780 671
1 810 671
1 810 701
1 810 731
1 810 761
1 810 791
1 780 791
1 780 761
1 780 731
1 780 701
