1 60 101
1 90 101
1 90 131
1 70 131
1 60 131
1 60 161
1 90 161
1 90 191
1 60 191
1 60 221
1 90 221
1 90 251
1 60 251
1 180 251
1 210 251
1 210 221
1 210 191
1 210 161
1 210 131
1 210 101
1 180 101
1 300 101
1 320 101
1 330 101
1 420 101
1 450 101
1 540 101
1 570 101
1 570 131
1 540 131
1 660 101
1 690 101
1 780 101
1 810 101
1 450 131
1 420 131
1 420 161
1 420 191
1 420 221
1 420 251
1 450 251
1 450 221
1 450 191
1 450 161
1 900 101
1 930 101
1 930 131
1 930 161
1 930 191
1 930 221
1 930 251
1 900 251
1 810 251
1 780 251
1 690 131
1 690 251
1 660 251
1 570 251
1 540 251
1 330 251
1 300 251
0 480 221
0 510 221
0 510 191
0 480 191
1 180 221
1 180 191
1 180 161
1 180 131
1 300 131
1 330 131
1 330 161
1 330 191
1 330 221
1 300 221
1 300 191
1 300 161
1 540 161
1 570 161
1 570 191
1 540 191
1 540 221
1 570 221
1 660 221
1 660 191
1 660 161
1 660 131
1 690 161
1 690 191
1 690 221
1 780 221
1 780 191
1 780 161
1 780 131
1 810 131
1 810 161
1 810 191
1 810 221
1 900 221
1 900 191
1 900 161
1 900 131
1 60 281
1 90 281
1 180 281
1 210 281
1 300 281
1 690 281
1 780 281
1 810 281
1 900 281
1 930 281
1 120 371
1 120 401
1 340 401
1 340 371
1 150 371
1 180 371
1 210 371
1 240 371
1 270 371
1 300 371
1 310 371
1 310 401
1 280 401
1 250 401
1 220 401
1 190 401
1 160 401
1 150 401
1 420 331
1 450 331
1 450 361
1 420 361
1 540 361
1 540 331
1 570 331
1 570 361
1 660 371
1 690 371
1 660 401
1 690 401
1 870 371
1 840 371
1 810 371
1 780 371
1 750 371
1 720 371
1 720 401
1 750 401
1 780 401
1 810 401
1 840 401
1 870 401
0 0 461
0 30 461
0 990 461
0 960 461
1 420 481
1 450 481
1 540 481
1 570 481
1 570 511
1 570 541
1 570 571
1 570 601
1 570 631
1 540 631
1 540 601
1 540 571
1 540 541
1 540 511
1 510 511
1 480 511
1 480 541
1 510 541
1 450 541
1 450 511
1 420 511
1 420 541
1 420 571
1 420 601
1 420 631
1 450 631
1 450 601
1 450 571
1 60 511
1 90 511
1 90 541
1 90 571
1 90 601
1 90 631
1 90 661
1 90 691
1 90 721
1 90 751
1 60 751
1 60 721
1 60 691
1 60 661
1 60 631
1 60 601
1 60 571
1 60 541
1 180 511
1 210 511
1 210 541
1 180 541
1 180 571
1 180 601
1 180 631
1 180 661
1 180 691
1 180 721
1 180 751
1 210 751
1 210 721
1 210 691
1 210 661
1 210 631
1 210 601
1 210 571
1 930 511
1 900 511
1 900 541
1 930 541
1 930 571
1 930 601
1 930 631
1 930 661
1 930 691
1 930 721
1 930 751
1 900 751
1 900 721
1 900 691
1 900 661
1 900 631
1 900 601
1 900 571
1 810 511
1 790 511
1 780 511
1 780 541
1 810 541
1 810 571
1 780 571
1 780 601
1 810 601
1 810 631
1 780 631
1 780 661
1 810 661
1 810 691
1 780 691
1 780 721
1 810 721
1 810 751
1 780 751
1 450 851
1 450 821
1 450 791
1 480 791
1 510 791
1 540 791
1 540 821
1 540 851
2 120 531
2 120 591
2 840 591
2 840 531
2 240 511
2 300 511
2 360 511
2 600 511
2 660 511
2 720 511
2 720 721
2 660 721
2 600 721
2 540 721
2 480 721
2 420 721
2 360 721
2 300 721
2 240 721
3 480 331
